B	G	G	G	G	G	G	G	G	G	G	G	G	G	G	G	G	G	G	G	B
B	G	F	F	F	X	F	F	F	F	G	F	F	F	F	F	F	F	F	G	B
B	G	F	G	G	F	G	G	G	F	G	F	G	G	G	F	G	G	F	G	B
B	G	F	F	F	F	F	F	F	F	F	F	F	F	F	F	F	F	F	G	B
B	G	F	G	G	F	G	F	G	G	G	G	G	F	G	F	G	G	F	G	B
B	G	F	F	F	F	G	F	F	F	G	F	F	F	G	F	F	F	F	G	B
B	G	G	G	G	F	G	G	G	F	G	F	G	G	G	F	G	G	G	G	B
B	B	B	B	G	F	G	F	F	F	F	F	F	F	G	F	G	B	B	B	B
G	G	G	G	G	F	G	F	G	G	G	G	G	F	G	F	G	G	G	G	G
F	F	F	F	F	F	F	F	G	B	B	B	G	F	F	F	F	F	F	F	F
G	G	G	G	G	F	G	F	G	G	G	G	G	F	G	F	G	G	G	G	G
B	B	B	B	G	F	G	F	F	F	F	F	F	F	G	F	G	B	B	B	B
B	G	G	G	G	F	G	F	G	G	G	G	G	F	G	F	G	G	G	G	B
B	G	F	F	F	F	F	F	F	F	G	F	F	F	F	F	F	F	F	G	B
B	G	F	G	G	F	G	G	G	F	G	F	G	G	G	F	G	G	F	G	B
B	G	F	F	G	F	F	F	F	F	H	F	F	F	F	F	G	F	F	G	B
B	G	G	F	G	F	G	F	G	G	G	G	G	F	G	F	G	F	G	G	B
B	G	F	F	F	F	G	F	F	F	G	F	F	F	G	X	F	F	F	G	B
B	G	F	G	G	G	G	G	G	F	G	F	G	G	G	G	G	G	F	G	B
B	G	Y	F	F	F	F	F	F	F	F	F	F	F	F	F	F	F	F	G	B
B	G	G	G	G	G	G	G	G	G	G	G	G	G	G	G	G	G	G	G	B